#############################################
#..@...........#.............#..............#
#..........?...#.............#..............#
########..........A..........#..............#
#......#########.............#..............#
#......#.....................##.............#
#......#.....A.........#################....#
#....###...............................#....#
#......................................#....#
####################...................#....#
#..................#...................#....#
#..................##########...............#
#...........................................#
#############################################