#############################################
#.X@..A........#.............#..............#
#..........X...#.............#..............#
########..........A..........#..............#
#......#########......X......#..............#
#......#.....................##.............#
#......#.....A.........#################....#
#....###........X......................#....#
#......................................#....#
####################...................#....#
#..................#...................#....#
#..................##########...............#
#...........................................#
#############################################