#############################################
#..............#.............#..............#
#..@...........#.............#..............#
########.....................#..............#
#......#########.............#..............#
#......#.....................##.............#
#......#...............#################....#
#....###...............................#....#
#......................................#....#
####################...................#....#
#..................#...................#....#
#..................##########...............#
#...........................................#
#############################################